# Syntax Coloring Map For AS5X47

# Datatypes (KEYWORD1)
mt_status_t	KEYWORD1		DATA_TYPE
calibration_status_t	KEYWORD1		DATA_TYPE
Angle	KEYWORD1		DATA_TYPE
ABZ_RES	KEYWORD1		DATA_TYPE
CommandFrame	KEYWORD1		DATA_TYPE
MT6835	KEYWORD1		DATA_TYPE

# Methods and Functions (KEYWORD2)
MT6835	KEYWORD2
readRegister	KEYWORD2
readRegisterContinus	KEYWORD2
writeRegister	KEYWORD2
writeAbzRes	KEYWORD2
writeEEprom	KEYWORD2
autoSetZeroPoint	KEYWORD2
readAngleByte  KEYWORD2
readAngle  KEYWORD2
readCalibrationStatus  KEYWORD2
printDebugString  KEYWORD2

# Instances (KEYWORD2)

# Structures (KEYWORD3)
raw	KEYWORD3
values	KEYWORD3

# Constants (LITERAL1)
USER_ID	LITERAL1	RESERVED_WORD_2
NOT_USED	LITERAL1	RESERVED_WORD_2
ANGLE_H	LITERAL1	RESERVED_WORD_2
ANGLE_M	LITERAL1	RESERVED_WORD_2
ANGLE_L	LITERAL1	RESERVED_WORD_2
ANGLE_CRC	LITERAL1	RESERVED_WORD_2
ABZ_RESOLUTION_H	LITERAL1	RESERVED_WORD_2
ABZ_RESOLUTION_L	LITERAL1	RESERVED_WORD_2
AUTOCAL_FREQ	LITERAL1	RESERVED_WORD_2
CALIBRATION_STATUS	LITERAL1	RESERVED_WORD_2
WRITE	LITERAL1	RESERVED_WORD_2
READ	LITERAL1	RESERVED_WORD_2
WRITE_EEPROM	LITERAL1	RESERVED_WORD_2
SET_ZERO_POINT	LITERAL1	RESERVED_WORD_2
CONTINOUS_READ	LITERAL1	RESERVED_WORD_2
ACK_DATA	LITERAL1	RESERVED_WORD_2
